1111111111
14    4  1
1  33   41
1 3 333  1
1 3   3 41
1  3 33   
13 3   3 1
1  3 2  31
1 3  22  1
1   2  2 1
1^2  2   1
1111111111
